7 13
0000001000000
1101111111010
0100000000010
0101100111010
0001000001010
0111110101010
0000200100100
